Solence: Rad --> Ruud Gullit --> Rad --> Solence
KaMa888: Gibby --> Fade Away --> KaMa888.o_0 --> KaMa888
Björn: Erling Haaland --> Björn
pressure: skit --> virginia --> pressure
k1dcud1: Tamara --> joji --> berserk --> syzn4love --> k1dcud1
Toni Kukoč: рсптншк -->  electronique --> Rsptn --> Hemingway --> elias --> sakur --> Toni Kukoč
54: Oliver --> Olya --> 54
lotte: Damien --> Claude Makélélé --> damien- --> Alenichka --> lotte
zark-: Zark --> zark-
ninowka: мастер хакса --> spleensauce --> великий --> овечка --> m1ld1 --> ninowka
ya tyanochka: великая --> ya tyanochka --> Куроме --> yuno gasai --> ya tyanochka
gambling: trowll --> gambling
Yamakasi: fruttis --> ya tiktoker --> Yamakasi
Aiowie: WildHonor --> Хонір --> Aiowie
Nujabes: Young Sinatra --> Nujabes
Scottie Pippen: Kostrov --> Scottie Pippen
Пика: DELORIAN1 --> Пика
Sиdney L: Pluvia Sonitus --> Sиdney L
Жмых: Жмых --> Младен Нормич --> Жмых
sunshine: sanji --> sunshine
kominoi: Conqueror --> Okomuro --> kominoi
iwd: iwdkun --> iwd --> tofa --> qawwi --> mint --> iwd
yokk: uno --> -yoKid- --> y0kkk --> yokk
laamb: Mateo Kovacic --> laambgoD --> god --> depressed kid --> laamb
warlock: Makes --> warlock
Puerto: Буфонище --> Puerto
bau: Fuoco d'artificio --> сосна --> Салют --> bau
osako: Osako --> awii --> ósako --> osako
koopinoff: антоха12лет --> тоха2009play --> koopinoff --> Акаме --> koopinoff
buda: buda --> пикадорчик --> buda
Filp: Filpufka --> Filp
Avis: dove --> Avis
dupe: dupe --> pash --> ХХ Флотоводец --> caramelcandy --> dupe
Yves: Дядюшка ау --> Montana21 --> Mont --> Love is Mont --> Yves
acmew: https --> acmew
Eyeless: Bubblehead --> Eyeless
dff: 20.07.2020 --> dff
oshi: skippa --> k. - ralf - Двачевский --> Aveo --> oshi
ичто: Kuala --> Че --> ичто
yowai: Resist - Weather --> yowai
Ильяка: 6elorus1k --> Ильяка
Цезарь: Цезарек --> Цезарь
ллл: Нуб --> ллл
Shvetsarec: Швец --> Shvetsarec
arthur: de Faza - Faza --> Fatazaki --> arthur
hopeispreson: Савитар --> Angelochek --> hopeispreson
Phillip Brooks: Брукс --> Phillip Brooks
step-: step --> step-
Yedlin: evian. --> Zurg --> yedlinny --> Yedlin
Buck Lloyd: Robert P --> Buck Lloyd
sbt: iloveyou --> sbt
как так?: фругер --> wxzcxd --> как так?
ozone: ozone --> mdmamdada --> ozone
Mokujin: togaaaa --> bot666 --> Mokujin
Jorge: fleet --> Mas Fuerte --> Messi --> силентиум --> Jorge
kdb: папочка kdb --> kdb
rpdk: дед инсайд --> mi4zz --> Зачем --> rpdk
krizzen: Goki --> goki4ka - krizzen
Pharaoh: David De Gea --> Pharaoh
goku: killua --> ame --> goku
Yuppie: hertz --> Yuppie
oweex: футболист1 --> oweex
UHvBnDestroed: роналдо7 --> UHvBnDestroed --> 16th.dOFs-s3 --> UHvBnDestroed
daz: месси10 --> корифей --> daz
jz: ᴋʏᴀᴍɪ|ツ --> jz
Скобки: D2 --> Скобки
sahaja: DREAM --> Zein --> odditi3s --> Dream --> снеговик--> sahaja
snappi: IGROW0MAN --> snappi
девочка из кони-айленд: Andy_ --> pdml --> девочка из кони-айленд
qudara: shepeedo --> yvn --> qudara
meooow?: Jessîco --> Варяг --> meooow?
BLOoOdy: ЗССПоПП --> Калатилов --> Poulauskas --> rush --> BLOoOdy
nsd: анальдо --> nsd
Winnyy: Son Goku --> -Winny- --> maksur --> Winnyy
bushido: Stand --> Astik --> bushido
whyusad: Nevskiy --> whyusad
Owenau: Дибала --> Owenau
H1: хектор --> H1
Toolerat: WerfyXD --> Toolerat
pyrokinesis: Karas --> pyrokinesis
ssd-: Ner0x --> ssd-
60 hz: vst --> 60 hz
ctrl: Sergeev --> ctrl
akashi: marsel --> akashi
kovboi: SMag --> смаг --> kovboi
b9: 69UK --> b9
Shift: Vini.Jr --> Shift
shimmer: шиммер --> shim --> Bayartsengel Purevdorj --> shimmer
Tokito: mosti --> mosty --> eyle --> Tokito -_- --> Tokito
Ya Matte Kudasai: Лапух --> `da Vinci --> yukimatsu. --> Ya Matte Kudasai
ReZ: Мопс на пляже --> ReZ
hat-: hat --> hat-
meowmilash: Дура --> lampovayanyasha --> meowmilash
adriano: adriano --> tik --> adriano
ничто: Wexsidik --> ничто
dasha epta: dasha epta --> Nя- --> dasha epta
rebbe: Vedernikov --> rebbe
kidaiblock: spec --> Kanaplyanka --> kidaiblock
Larsson: Larsson --> maddyson --> jzxdx --> Larsson
Twistzz: Twistzz --> Convindix --> Twistzz
Вампи.: VampAthem  --> Вампи.
nevzyy: zxcnvzx --> nevzyy
coyc: Grac --> coyc
Supersonic: 7f --> Supersonic
Isagi: Spesh --> Isagi
totti: Смешарик --> totti
1tam: dj sex --> 1tam
honey: wpdh --> honey
swarqa: vanyushka --> swarqa
ShowMaker-: Алиша Кларк- --> ShowMaker-
Yoko: keda --> Yoko
Kotomine Kirei: hornyasuka --> Kotomine Kirei